; 1

###################
# # #   #         E
# # ### # ### ### #
#     #   #     # #
### ### ####### ###
#       #   # #   #
# ### # # ### #####
# #   #     # #   #
# # ##### # # # ###
# # #   # # #     #
# # # ### ### # # #
# #   #       # # #
# # ####### ##### #
# # #           # #
### ### ### ### ###
# #   #   # #     #
# ### # # # #######
#@    # # #       #
###################

; 2

###################
# # #     #       E
# # # ### ### # ###
# #   # #     #   #
# ##### # # ### ###
# # #   # # #     #
# # # ##### ### ###
#   # # #   #     #
# # # # # ### ### #
# #         # #   #
# ### ####### #####
# #       #     # #
########### ### # #
#   #   #   #     #
# # # ########### #
# # #     #     # #
### # ######### # #
#@                #
###################

; 3

###################
#   #     #   #   E
### # # ##### ### #
#     #     # #   #
##### # ##### ### #
#     #   # #   # #
######### # # ### #
# #         # #   #
# ####### ### # # #
# # #           # #
# # # ##### # # # #
# #     #   # # # #
# # ######### #####
#     # #       # #
### # # ####### # #
#   #     #       #
# ### # # ### #####
#@  # # # #       #
###################

; 4

###################
# # #             E
# # # # ##### # ###
#   # # # #   #   #
# ####### # ##### #
# # #   #   #   # #
# # ### ### # # # #
#     #     # # # #
# # # # ### ### ###
# # #     # #     #
##### ### ##### ###
#   # # #         #
# ### # # # ### # #
# # # #   #   # # #
# # ######### # ###
#   # # # #   #   #
# ### # # # # ### #
#@          # #   #
###################

; 5

###################
#       #         E
# ##### # ##### ###
#   # #     # #   #
# ### ####### # ###
#           #     #
# # ######### #####
# # # #   # # #   #
# ### # ### ### ###
#         #   #   #
# ### ##### # # ###
# #   #   # #     #
### # ### ##### ###
#   # # # # #     #
# ### # # # ### # #
# #       #   # # #
# ### ##### # # # #
#@  #       #   # #
###################

; 6

###################
#   # #       # # E
### # ####### # # #
#           # # # #
# ### # # ### # # #
#   # # #         #
# ####### # # # ###
#       # # # # # #
# ####### ### ### #
#   #       # #   #
##### # # ### # # #
#     # # # #   # #
### ####### # # # #
#   #         # # #
# ##### ####### ###
# #   #       #   #
### ##### ### ### #
#@        #   #   #
###################

; 7
###################
#       #     #   E
# # # ### ### ### #
# # #   #   #     #
# ### ##### # # ###
# #     # # # #   #
##### ### # # ### #
# # # # #   # #   #
# # # # # # ### # #
# #       #   # # #
# ############### #
#     #       # # #
# ### # # ##### # #
# #   # #   # #   #
##### # # ### # # #
# # #   #   #   # #
# # # # ##### ### #
#@    #         # #
###################
 
; 8

###################
# #               E
# ### # ##### ### #
#     #     #   # #
# # # ### ### # ###
# # # # # #   #   #
### # # # # ##### #
#   #   # # #   # #
# ### # ##### ### #
# #   # #         #
# # # ##### ### ###
# # # # # # #     #
# ### # # # ##### #
# # #   #       # #
# # # # ### # ### #
# #   # #   #   # #
### ####### #######
#@    #           #
###################

; 9

###################
#     #       #   E
# ### ##### ### # #
# #         #   # #
# ##### # ### # ###
#     # # #   #   #
# # ##### ####### #
# #   #           #
### ### ##### # # #
# # #       # # # #
# # ### # ### ### #
#   # # #   # #   #
##### ########### #
#   #             #
# # ### ######### #
# #             # #
# ### # ####### ###
#@  # #   #       #
###################

; 10

###################
#   #     #   #   E
# # ##### # # # # #
# #         #   # #
# ### ### #########
#   #   #   #     #
# # # ####### ### #
# # # # #     #   #
# # ### ### #######
# # # # # #       #
# ### # # # ### # #
# #   #     #   # #
# ### # ###########
# #   #           #
# ### # # ### #####
#   # # # # #     #
# # # # ### # #####
#@#         #     #
###################